NO ./textures/wood.xpm
SO ./textures/purplestone.xpm
WE ./textures/bluestone.xpm
EA ./textures/redbrick.xpm

F 28,175,255
C 0,255,255

      11
11111100111111111
10000000N00000001
10000000000000001
10000000000000001
10000000000000001
100000000000000001
100000000000000001
10000000000000001
10000000000000001
10000000000000001
10000000000000001
10000000000000001
11111111111111111